EEEEEEEE
XX1OOXXX
X1X11XXX
XXXXXXXX
X111XX1X
XXXXXXXX
