XEEEEEEE
DXXXXXXE
XXX41XXX
X42241XX
X1XXXXXX
OOOOOOOO
