ESEXXXXX
XX5XXXXX
EX1XXXEX
EO1XX1XX
1XXWEXXX
EX21W1EX
