XXEOXXXX
E1EO3XXX
DXXXXXXX
1E112XXX
1XXO2XXX
E(2)XE(2)OXXXX
